11111112222222
1111m112222222
111f1o122j2222
11M111!2f2f222
111c111o222C22
11f1o1o2r222d2
1m111c122f2f22
11c1f112j222a2
111M11122f2f22
111111t222d222
33333o333o3333
3333C3o3o3s333
333F333r333F33
33D333333333D3
333(333a333(33
33o3F3(3F3F333
3S333s333p3333
33333333333333